s #########################################
#   # #     #      #      #      #     #e #
# ###    #  ###   ######  #  ##  #  #  ## #
# # # ####    #      ###  #  ##  #  #  #  #
# # #    #    #  #   ###     ##  #  #  #  #
# # #  # # ####  #   ###  #  ##  #  #  #  #
# # #  # #       #        #  ##  #  #  #  #
# # #  # #########   ###  #  ##     #  #  #
#        #           ###  #  ##  #  #     #
###########################################
